25 24 
1 1 1 1 1 1 1 1 1 1 1 1 1 1 1 1 1 1 1 1 1 1 1 1 
1 0 0 0 0 0 0 0 0 0 0 0 0 0 0 0 0 0 0 0 0 0 0 1 
1 0 0 0 0 0 0 0 0 0 0 0 0 0 0 0 0 0 0 0 0 0 0 1 
1 0 0 0 0 0 0 0 0 0 0 0 0 0 0 0 0 0 0 0 0 0 0 1 
1 9 9 9 9 9 1 1 1 1 1 1 1 4 0 0 0 0 0 0 0 0 0 1 
1 0 0 0 0 0 0 0 0 0 0 0 1 8 4 0 0 0 0 0 0 0 0 1 
1 0 0 0 0 0 0 0 0 0 0 0 1 4 8 4 0 0 0 0 0 0 0 1 
1 1 1 1 1 1 1 1 1 1 5 5 1 1 1 1 1 1 1 7 7 0 0 1 
1 0 0 0 0 8 8 0 0 1 0 0 1 0 0 0 0 0 1 0 0 0 0 1 
1 0 0 0 0 0 0 0 0 1 0 0 1 0 0 0 0 0 1 0 0 0 0 1 
1 0 0 0 0 0 0 0 0 1 0 1 1 0 0 0 0 0 1 0 0 0 0 1 
1 0 0 11 0 1 0 0 0 1 0 1 1 0 0 1 8 8 1 0 0 0 0 1 
1 0 0 0 0 1 0 0 0 1 0 0 1 0 0 1 0 0 1 0 0 0 0 1 
1 0 0 0 0 1 3 0 0 1 0 17 1 0 9 1 0 0 1 0 0 0 0 1 
1 0 0 0 0 1 0 0 0 1 1 1 1 10 9 1 0 0 1 0 0 0 0 1 
1 0 0 0 0 1 0 0 3 1 1 1 1 1 1 1 4 4 1 0 0 0 0 1 
1 0 0 0 0 1 0 0 0 0 0 0 0 0 0 0 0 0 1 0 0 0 0 1 
1 0 0 0 0 1 3 0 0 0 0 0 0 0 0 0 0 0 1 0 0 0 0 1 
1 0 0 0 0 1 0 0 0 0 0 0 0 0 0 0 0 0 1 0 0 0 0 1 
1 0 0 0 0 1 1 1 1 1 1 1 1 1 1 1 1 1 1 0 0 0 0 1 
1 0 0 0 0 0 0 0 0 0 0 0 0 0 0 0 0 0 0 0 0 0 0 1 
1 0 0 0 0 0 0 0 0 0 0 0 0 0 0 0 0 0 0 0 0 0 0 1 
1 0 0 0 0 0 0 0 0 0 0 9 0 0 0 0 9 0 0 0 0 0 0 1 
1 0 0 8 2 0 0 0 0 0 0 0 0 0 0 0 0 0 0 0 0 8 13 1 
1 0 0 0 0 0 0 0 0 0 0 0 0 0 0 0 0 0 0 0 0 0 0 1 
