30 50 

0 0 0 0 0 0 0 0 0 0 0 0 0 0 0 0 0 0 0 0 0 0 0 1 1 1 1 1 1 1 1 1 1 1 1 1 1 1 1 0 0 0 0 0 0 0 0 0 0 0 0 0 0 0 0 0 0 0 0 0 0 0 0 0 0 0 0 0 0 0 0 0 0 0 0 0 0 0 0 0 0 0 0 0 0 0 0 0 0 0 0 0 0 0 0 0 0 0 0 0 

0 0 0 0 0 0 0 0 0 0 0 0 0 0 0 0 0 0 0 0 0 0 0 1 0 0 0 0 0 0 0 0 0 0 0 0 0 0 1 0 0 0 0 0 0 0 0 0 0 0 0 0 0 0 1 1 1 1 1 1 1 1 1 1 1 1 1 1 1 1 1 1 1 1 0 0 0 0 0 0 0 0 0 0 0 0 0 0 0 0 0 0 0 0 0 0 0 0 0 0 

0 0 0 0 0 0 0 0 0 0 0 0 0 0 0 0 0 0 0 0 0 0 0 1 0 0 0 0 0 0 0 0 0 0 0 0 0 0 1 0 0 0 0 0 0 0 0 0 0 0 0 0 0 0 1 0 0 0 0 0 0 0 0 0 0 0 0 0 0 0 0 0 0 1 0 0 0 0 0 0 0 0 0 0 0 0 0 0 0 0 0 0 0 0 0 0 0 0 0 0 

0 0 0 0 0 0 0 0 0 0 0 0 0 0 0 0 0 0 0 0 0 0 0 1 0 0 0 0 0 0 0 0 0 0 0 0 0 0 1 0 0 0 0 0 0 0 0 0 0 0 0 0 0 0 1 0 0 0 0 0 0 0 0 0 0 0 0 0 0 0 0 0 0 1 0 0 0 0 0 0 0 0 0 0 0 0 0 0 0 0 0 0 0 0 0 0 0 0 0 0 

0 0 0 0 0 0 0 0 0 0 0 0 0 0 0 0 0 0 0 0 0 0 0 1 0 0 0 0 0 0 0 0 0 0 0 0 0 0 1 0 0 0 0 0 0 0 0 0 0 0 0 0 0 0 1 0 0 0 0 0 0 0 0 0 0 0 0 0 0 0 0 0 0 1 0 0 0 0 0 0 0 0 0 0 0 0 0 0 0 0 0 0 0 0 0 0 0 0 0 0 

0 0 0 0 0 0 0 0 0 0 0 0 0 0 0 0 0 0 0 0 0 0 0 1 0 0 0 0 0 0 0 0 0 0 0 0 0 0 1 1 1 1 1 1 1 1 1 1 1 1 0 0 0 0 1 0 0 0 0 0 0 0 0 0 0 0 0 0 0 0 0 0 0 1 1 1 1 1 1 1 1 1 1 1 1 1 1 1 1 1 1 1 1 1 1 1 1 1 1 1 

0 0 0 0 0 0 0 0 0 0 0 1 1 1 1 1 1 1 1 1 1 1 1 1 0 0 0 0 0 0 0 0 0 0 0 0 0 0 1 1 1 1 1 1 1 1 1 1 1 1 1 1 1 1 1 0 0 0 0 0 0 0 0 0 0 0 0 0 0 0 0 0 0 1 1 1 1 1 1 1 1 1 1 1 1 1 1 1 1 1 1 1 1 1 1 1 1 1 1 1 

0 0 0 0 1 1 1 1 1 1 1 1 0 0 0 1 0 0 0 0 0 0 0 1 0 0 0 0 0 0 0 0 0 0 0 0 0 0 1 1 1 1 1 1 1 1 1 1 1 1 1 1 1 1 1 0 0 0 0 0 0 0 0 0 0 0 0 0 0 0 0 0 0 1 0 0 0 0 9 9 9 9 0 0 0 0 0 0 0 0 0 0 0 1 0 0 0 0 0 1 

1 1 1 1 1 0 0 0 0 0 0 0 0 0 0 1 0 0 0 0 0 0 0 1 0 0 0 0 0 0 0 0 0 0 0 0 0 0 1 0 0 0 0 0 0 0 0 0 0 0 1 1 1 1 1 0 0 0 0 0 0 0 0 0 0 0 0 0 0 0 0 0 0 1 0 0 0 0 9 9 9 9 0 0 0 0 0 0 0 0 0 0 0 1 0 0 0 0 0 1 

1 0 0 0 1 0 0 0 0 0 0 0 0 0 14 1 0 1 1 1 11 1 7 0 0 0 0 0 0 0 0 0 0 0 15 0 0 0 1 0 0 0 0 0 0 0 0 0 0 0 0 0 0 0 0 0 0 0 0 0 0 0 0 0 0 0 0 0 0 0 0 0 0 1 1 1 1 1 1 1 1 1 1 9 1 9 1 9 1 9 1 1 0 1 0 0 1 1 0 1 

1 0 0 0 1 0 0 0 1 1 1 1 9 1 5 1 0 1 0 0 0 0 0 1 0 13 0 0 0 0 0 0 0 0 0 0 0 0 1 0 0 0 0 0 0 0 0 0 0 0 0 0 0 0 0 0 0 0 0 0 0 12 0 0 0 0 2 0 11 0 0 0 0 0 0 0 0 0 0 0 0 8 0 0 0 8 0 9 0 8 0 1 0 0 0 0 1 1 0 1 

1 0 0 0 0 0 0 0 0 0 0 0 0 0 0 0 0 1 0 0 0 0 2 0 0 0 0 0 0 0 0 0 0 0 0 0 0 11 0 9 0 0 0 0 0 0 0 0 1 1 0 0 9 5 0 0 0 0 2 0 0 0 0 16 0 0 0 0 0 0 5 16 9 0 0 0 0 0 0 0 0 0 0 0 0 0 0 0 0 0 0 1 0 0 0 0 0 0 0 1 

1 0 0 0 0 0 5 0 0 0 0 0 0 0 0 0 0 1 0 0 0 0 0 0 0 0 0 0 0 0 5 0 0 0 0 13 0 0 0 0 0 0 0 0 0 1 1 1 1 1 1 3 0 0 7 1 1 0 0 0 16 0 0 0 2 0 14 0 6 0 15 5 2 0 0 0 1 14 0 0 0 4 1 4 1 4 0 4 1 4 1 1 13 1 1 0 0 0 0 1 

1 2 0 0 9 0 0 0 0 9 7 3 0 8 0 0 0 1 0 0 0 0 0 0 0 0 0 14 0 0 0 0 0 0 0 1 0 0 0 16 0 0 1 1 1 1 1 1 1 1 1 0 0 0 0 0 0 16 0 0 0 6 14 0 0 0 0 15 0 0 5 14 9 0 0 0 0 0 0 0 5 1 5 0 5 0 5 1 5 0 5 1 1 1 1 0 0 0 0 1 

1 0 0 0 9 0 0 0 0 0 0 0 0 0 0 1 16 1 0 0 5 2 0 0 0 0 0 0 0 0 0 0 0 0 0 0 0 5 9 1 1 1 1 1 1 1 1 1 1 1 1 0 7 7 0 0 0 0 0 14 0 0 0 0 0 12 0 0 16 0 0 0 0 0 0 0 0 0 0 9 1 9 0 9 1 9 1 9 1 9 0 0 0 5 0 0 0 0 0 1 

1 10 5 0 9 0 0 0 0 0 0 0 0 0 0 1 14 0 0 0 0 0 0 0 0 0 0 0 0 0 0 0 0 0 0 0 0 0 0 1 1 1 1 1 1 1 1 1 1 1 1 0 0 0 0 0 0 0 12 0 0 0 0 2 0 0 0 11 0 0 13 0 15 0 0 0 1 0 1 3 7 3 3 7 7 3 7 7 3 3 7 5 0 5 0 0 13 16 13 1 

1 9 9 9 9 0 0 16 0 0 0 15 1 0 1 0 9 1 1 1 1 1 0 0 0 0 0 0 0 0 0 0 0 0 0 0 0 0 0 1 1 1 1 1 1 1 1 1 1 1 1 0 0 0 0 0 0 13 0 2 0 15 0 0 0 0 16 0 0 2 0 14 0 0 0 0 1 1 1 0 0 0 0 0 0 0 0 0 0 0 0 1 9 5 1 1 1 1 1 1 

