15 100 
0 0 0 0 0 0 0 0 0 0 0 0 0 0 0 0 0 0 0 0 0 0 0 0 0 0 0 0 0 0 0 0 0 0 0 0 0 0 0 0 0 0 0 0 0 0 0 0 0 0 0 0 0 0 0 0 0 0 0 0 0 0 0 0 0 0 0 0 1 1 1 1 1 1 1 1 1 1 1 0 0 0 0 0 0 0 0 0 0 0 0 0 0 0 0 0 0 0 0 0 

0 0 0 0 0 0 0 0 0 0 0 0 0 0 0 0 0 0 0 0 0 0 0 0 0 0 0 0 0 0 0 0 0 0 0 0 0 0 0 0 0 0 0 0 0 0 0 0 0 0 0 0 0 0 0 0 0 0 0 0 0 0 0 0 0 0 0 0 1 0 0 0 0 0 0 0 1 1 1 0 0 0 0 0 0 0 0 0 0 0 0 0 0 0 0 0 0 0 0 0 

0 0 0 0 0 0 0 0 0 0 0 0 0 0 0 0 0 0 0 0 0 0 0 0 0 0 0 0 0 0 0 0 0 0 0 0 0 0 0 0 0 0 0 0 0 0 0 0 0 0 0 0 0 0 0 0 0 0 0 0 0 0 0 0 0 0 0 0 1 0 0 0 0 0 0 0 1 1 1 0 0 0 0 0 0 0 0 0 0 0 0 0 0 0 0 0 0 0 0 0 

0 0 0 0 0 0 0 0 0 0 0 0 0 0 0 0 0 0 0 0 0 0 0 0 0 0 0 0 0 0 0 0 0 0 0 0 0 0 0 0 0 0 0 0 0 0 0 0 0 0 0 0 0 0 0 0 0 0 0 0 0 0 0 0 0 0 0 0 1 0 0 0 0 0 0 0 1 1 1 0 0 0 0 0 0 0 0 0 0 0 0 0 0 0 0 0 0 0 0 0 

0 0 0 0 0 0 0 0 0 0 0 0 0 0 0 0 0 0 0 0 0 0 0 0 0 0 0 0 0 0 0 0 0 0 0 0 0 0 0 0 0 0 0 0 0 0 0 0 0 0 0 0 0 0 0 0 0 0 0 0 0 0 0 0 0 0 0 0 1 0 0 0 0 0 0 0 1 1 1 0 0 0 0 0 0 0 0 0 0 0 0 0 0 0 0 0 0 0 0 0 


0 0 0 1 1 1 1 1 1 1 1 1 1 1 1 1 1 1 1 1 1 1 1 1 1 1 1 1 1 1 1 1 1 1 1 1 1 1 1 1 1 1 1 1 1 1 1 1 1 1 0 0 0 0 0 0 0 0 0 0 0 0 0 0 0 0 0 0 1 0 0 0 0 0 0 0 1 1 1 0 0 0 0 0 0 0 0 0 0 0 0 0 0 0 0 0 0 0 0 0 

1 1 10 0 0 0 0 0 0 0 0 0 0 5 0 0 0 0 9 9 0 0 0 5 5 5 0 0 0 9 9 9 9 0 0 0 0 0 0 0 0 0 0 0 0 0 0 0 1 1 1 1 1 1 1 1 1 1 1 1 1 1 1 1 1 1 1 1 1 0 0 1 1 1 0 0 1 1 1 1 1 1 1 1 1 1 1 1 1 1 1 1 1 1 1 1 1 1 1 1 

1 0 0 0 0 0 0 0 0 0 0 0 0 5 0 0 0 0 9 9 0 0 0 5 5 5 0 0 0 9 9 9 9 0 0 0 0 0 0 0 0 0 0 0 0 0 0 0 1 1 1 0 0 0 0 0 0 0 0 0 0 0 0 0 0 0 0 0 0 0 0 0 0 0 0 0 1 1 1 6 0 2 0 14 0 11 0 15 0 12 0 0 0 0 5 0 1 0 0 0 

1 0 2 0 0 0 0 0 0 0 0 1 1 1 3 1 1 1 1 1 7 1 1 1 1 1 3 1 1 1 1 1 1 7 1 6 0 0 5 7 5 0 0 0 0 0 0 0 1 1 1 0 0 0 0 0 0 0 0 0 0 0 0 0 0 0 0 0 0 0 0 0 0 0 0 0 0 0 0 0 6 0 2 0 14 0 11 0 15 0 12 0 0 0 5 0 0 1 0 0 

1 0 0 0 1 1 0 0 0 0 0 0 0 0 0 0 0 0 9 0 0 9 9 9 9 9 0 0 9 9 9 9 9 0 1 0 0 0 5 5 5 0 9 3 9 0 0 0 1 1 1 0 0 0 0 0 0 0 0 0 0 0 0 0 0 0 0 0 0 0 0 8 16 8 0 0 0 0 0 0 0 6 0 2 0 14 0 11 0 15 0 12 0 0 5 0 0 0 1 0 


1 0 0 0 0 0 0 0 0 0 0 0 0 0 0 9 9 9 9 9 0 9 0 0 0 9 0 0 9 0 0 0 9 0 1 0 0 0 0 0 0 0 9 9 9 0 0 0 1 1 1 0 0 0 0 0 0 0 0 0 0 0 0 9 9 0 0 3 3 0 0 15 9 6 0 0 0 0 0 0 0 0 6 0 2 0 14 0 11 0 15 0 12 0 5 0 0 0 0 1 

1 5 0 0 0 0 0 1 1 1 0 0 0 0 0 0 0 9 9 0 0 0 0 0 0 9 0 9 0 9 9 0 9 0 1 0 0 0 0 0 0 0 0 0 0 0 0 12 1 1 1 0 0 0 0 0 0 0 0 0 0 0 0 9 9 0 0 7 7 0 0 8 14 8 0 0 1 1 1 6 0 2 0 14 0 11 0 15 0 12 0 0 0 0 9 0 0 0 0 1 

1 0 6 0 0 0 0 0 0 0 0 0 0 0 0 0 5 0 5 0 0 0 0 0 5 0 0 0 0 0 0 5 0 0 1 0 5 5 5 7 7 9 9 9 0 0 0 0 0 0 0 0 0 0 0 0 0 0 0 0 0 5 5 0 0 7 7 0 0 0 0 0 0 0 0 0 1 1 1 0 6 0 2 0 14 0 11 0 15 0 12 0 0 0 9 0 0 0 1 0 

1 0 0 0 0 0 0 1 1 1 1 0 0 0 0 5 0 0 5 0 0 0 0 5 0 0 0 0 0 0 5 0 0 0 1 0 5 8 5 0 0 9 4 9 0 0 0 0 0 0 0 0 0 0 0 0 0 0 0 0 1 5 5 0 0 3 3 0 0 0 0 0 0 0 0 0 1 1 1 0 0 6 0 2 0 14 0 11 0 15 0 12 0 0 9 0 0 1 0 0 1 1 1 1 9 9 9 9 9 9 1 0 0 0 0 0 0 0 0 13 16 1 

1 1 13 16 1 1 1 0 0 0 6 0 2 0 14 0 11 0 15 0 12 0 9 0 1 0 0 0 
1 0 0 0 0 0 0 0 0 0 0 0 0 0 0 0 0 0 0 0 0 0 0 0 0 0 0 0 0 12 0 0 0 0 1 0 5 5 5 3 3 9 9 9 2 0 0 0 1 1 
