11 100

0 0 0 0 0 0 0 0 0 0 0 1 1 1 1 1 1 1 0 0 0 0 0 0 0 0 0 0 0 0 0 0 0 0 0 0 0 0 0 0 0 0 0 0 0 0 0 0 0 0 0 0 0 0 0 0 0 0 0 0 0 0 0 0 0 0 0 0 0 0 0 0 0 0 0 0 0 0 0 0 0 0 0 0 0 0 0 0 0 0 0 0 0 0 0 0 0 0 0 0 
0 0 0 0 0 0 0 0 0 0 0 1 0 0 0 0 0 1 0 0 0 0 0 0 0 0 0 0 0 0 0 0 0 0 0 0 0 0 0 0 0 0 0 0 0 0 0 0 0 0 0 0 0 0 0 0 0 0 0 0 0 0 0 0 0 0 0 0 0 0 0 0 0 0 0 0 0 0 0 0 0 0 0 0 0 0 0 0 0 0 0 0 0 0 0 0 0 0 0 0 
1 1 1 1 1 1 1 1 1 1 1 1 0 0 0 0 0 1 1 1 1 1 1 1 1 1 1 1 1 1 1 1 1 1 1 1 1 1 1 1 1 1 1 1 1 1 1 1 1 1 1 1 1 1 1 1 1 1 1 1 1 1 1 1 1 1 1 1 1 1 1 1 1 1 1 1 1 1 1 1 1 1 1 1 1 1 1 1 1 1 1 1 1 1 1 1 1 1 1 1 

1 0 0 0 0 0 0 0 0 0 0 0 0 0 0 0 0 1 1 0 4 0 4 0 4 0 4 0 4 0 0 0 0 0 0 9 5 9 0 0 0 1 1 1 1 1 1 1 1 1 1 0 0 0 0 0 0 0 0 0 0 0 0 0 0 0 0 0 0 0 0 0 0 0 0 0 0 0 0 0 0 0 0 0 0 0 0 0 0 0 0 0 0 0 0 0 0 0 0 1 

1 0 0 0 0 0 0 0 0 0 0 0 0 1 1 7 7 1 1 0 0 8 0 8 0 8 0 8 0 0 0 0 0 0 0 9 5 9 0 0 0 1 1 1 1 1 1 1 1 1 1 0 0 0 0 0 0 0 0 0 0 0 0 0 0 0 0 0 0 0 0 0 0 0 0 0 0 0 0 0 0 0 0 0 0 0 0 0 0 0 0 0 0 0 0 0 0 0 0 1 

1 0 0 0 0 0 0 0 0 0 0 1 1 0 0 0 0 9 1 0 4 0 4 0 4 0 4 0 4 1 1 1 1 3 3 1 1 1 7 7 1 1 9 9 1 1 1 1 1 1 1 0 0 0 0 0 0 1 1 0 0 5 5 1 1 7 7 7 7 7 7 7 7 7 7 7 7 7 7 7 7 7 7 7 7 7 7 7 7 7 7 7 7 7 7 7 7 5 5 1 

1 0 0 0 0 0 0 0 0 1 1 1 1 0 0 0 0 9 1 0 0 8 0 8 0 8 0 8 0 1 1 1 1 0 0 1 1 1 0 0 0 0 0 0 9 9 0 0 0 0 0 0 0 0 0 1 1 1 1 0 0 5 5 1 1 5 0 0 0 0 0 0 0 0 0 0 0 0 0 0 0 0 0 0 0 0 0 0 0 0 0 0 0 0 0 0 0 1 1 1 

1 0 0 0 0 0 0 1 1 1 1 1 1 3 3 1 1 1 1 0 4 0 4 0 4 0 4 0 4 1 1 1 1 0 0 1 1 1 0 0 0 0 0 0 9 9 0 0 0 0 0 0 0 1 1 1 1 0 0 9 9 0 0 1 1 0 0 0 0 0 0 0 0 0 0 0 0 0 0 0 0 0 0 0 0 0 0 0 0 0 0 0 0 0 0 0 0 1 1 1 

1 0 0 0 0 1 1 1 1 1 1 1 1 0 0 0 0 0 0 0 0 8 0 8 0 8 0 8 0 1 1 1 1 0 0 1 1 1 0 0 5 5 3 3 1 1 1 1 1 1 1 1 1 1 1 0 0 0 0 9 9 0 0 1 1 3 3 3 3 3 3 3 3 3 3 3 3 3 3 3 3 3 3 3 3 3 3 3 3 3 3 3 3 3 3 3 3 1 0 0 

1 10 0 1 1 1 1 1 1 1 1 1 1 0 0 0 0 0 0 0 4 0 4 0 4 0 4 0 4 1 1 1 1 0 0 1 1 1 0 0 1 1 0 0 1 1 1 1 1 1 1 1 1 1 1 0 0 8 8 0 0 4 4 1 1 0 0 0 0 0 0 0 0 0 0 0 0 0 0 0 0 0 0 0 0 0 0 0 0 0 0 0 0 0 0 0 0 0 0 0 

1 1 1 1 1 1 1 1 1 1 1 1 1 1 1 1 1 1 1 1 1 1 1 1 1 1 1 1 1 1 1 1 1 0 0 1 1 1 0 0 1 1 0 0 1 1 1 1 1 1 1 1 1 1 1 0 0 8 8 0 0 4 4 1 1 6 0 0 0 0 0 0 0 0 0 0 0 0 0 0 0 0 0 0 0 0 0 0 0 0 0 0 0 0 0 0 0 0 0 1 

